WWWWWWWWWWWWWWWWWWWWWWWWWWWWWWWWWWWWWWWWWWWWWWWWWW
W  +                   +                    +    W
W   WWWWWWW  W        WWW         W  WWWWWWW     W
W   W     W  W                    W  W     W     W
W   WWWWWWW  W      W  +  W       W  WWWWWWW     W
W           +W      W     W       W+             W
W   WWWWWWWWWW      W  +  W       WWWWWWWWWW     W
W   W                                      W     W
W   W    +                             +   W     W
W   W                                      W     W
W                                                W
W                                                W
W   WWWWWWW          WWWWWWW         WWWWWWW     W
W   W     W          W     W         W     W     W
W   WWWWWWW          WWWWWWW         WWWWWWW     W
W      +                +               +        W
W   WWWWWWW          WWWWWWW         WWWWWWW     W
W   WWWWWWW          WWWWWWW         WWWWWWW     W
W                                                W
W                                                W
W                                                W
W  +                   +                    +    W
W   WWWWWWW  W        WWW         W  WWWWWWW     W
W   W     W  W                    W  W     W     W
W   WWWWWWW  W      W  +  W       W  WWWWWWW     W
W           +W      W     W       W+             W
W   WWWWWWWWWW      W  +  W       WWWWWWWWWW     W
W   W                                      W     W
W   W    +                             +   W     W
W   W                                      W     W
W                                                W
W                                                W
W   WWWWWWW          WWWWWWW         WWWWWWW     W
W   W     W          W     W         W     W     W
W   WWWWWWW          WWWWWWW         WWWWWWW     W
W      +                +               +        W
W   WWWWWWW          WWWWWWW         WWWWWWW     W
W   WWWWWWW          WWWWWWW         WWWWWWW     W
W                                                W
W                                                W
W                                                W
W  +                   +                    +    W
W   WWWWWWW  W        WWW         W  WWWWWWW     W
W   W     W  W                    W  W     W     W
W   WWWWWWW  W      W  +  W       W  WWWWWWW     W
W           +W      W     W       W+             W
W   WWWWWWWWWW      W  +  W       WWWWWWWWWW     W
W   W                                      W     W
W        +                             +         W
WWWWWWWWWWWWWWWWWWWWWWWWWWWWWWWWWWWWWWWWWWWWWWWWWW